11111111111111
11000000000X11
10000000000001
10000000000001
10000000000001
10011111111111
10001111111111
10000000000001
11111111111001
11111111111001
10000000000001
11111111111111
